NAME: MEDIUM_TEST
ROWS: 10
COLS: 20
SEED: 5678
WEATHER: NORMAL
MAP:
....................
.S----+----D........
......|.............
......|.............
.S----+----D........
......|.............
......|.............
.S----+----D........
....................
....................
SWITCHES:
TRAINS:
0 1 1 1 0
3 1 4 1 1
6 1 7 1 2
